1111111111
1P00000001
1000000001
1000000011
10000001E1
1000C00011
1000000001
10000C0001
1111111111