1111111111
1P10000001
1100000001
1000000001
10000000E1
1000C00001
1000000001
10000C0001
1111111111